
 Input: maze20.txt 
Maze: 
+ +-+-+-+-+-+-+-+-+-+-+-+-+-+-+-+-+-+-+-+
| |     |   |       | | |     |     |   |
+ + + + + +-+-+-+ + + + +-+ +-+-+ +-+-+ +
|   | |   |   |   |   | | |       |     |
+-+-+ +-+ + + +-+ + +-+ + + +-+-+ + + + +
|   | |   | | |   |   |         |   | | |
+-+ +-+-+ + +-+ +-+-+ +-+-+-+-+-+ + +-+ +
| | |             | |     |       | |   |
+ + + +-+ +-+-+-+-+ +-+ +-+-+ +-+-+ +-+-+
| |     |   |     |           |   | |   |
+ +-+-+ +-+-+-+ +-+-+-+ + +-+-+ +-+-+ +-+
| |   |     | |         |   | | |   |   |
+ +-+ + + +-+ + +-+-+-+ +-+-+ + + +-+-+ +
|   | | |   |       | | |     |         |
+ +-+ +-+-+-+ +-+-+-+ +-+ +-+ + +-+ +-+-+
|     | | |   |   | |   | |   | | | |   |
+-+ + + + + +-+-+ + +-+ + +-+ + + + + +-+
|   |   |                 | |   |     | |
+-+ +-+ + +-+ +-+-+-+ +-+-+ +-+ + +-+-+ +
|   |     | |   |           |   | |     |
+-+-+ + +-+ +-+-+ +-+-+ + +-+-+ + +-+ + +
| |   | |   |     | |   | |     | |   | |
+ + +-+-+ +-+ +-+ + +-+-+ +-+-+-+ +-+ +-+
|   | |       |   | |         | |   | | |
+ +-+ + +-+ +-+ +-+ +-+ + +-+-+ +-+-+ + +
| |       |   |   |   | | |       | |   |
+ + + +-+-+ +-+-+-+ +-+-+ + +-+-+ + + +-+
| | | | |   |   |   | | | |   |       | |
+-+-+-+ +-+ +-+ +-+ + + + + +-+-+ +-+ + +
| |   |           | |         |     |   |
+ + + +-+-+-+-+ + + + +-+ +-+ +-+ +-+ + +
| | |           | |   | |   |   |   | | |
+ +-+ +-+-+ + +-+ + + + + +-+ +-+-+ + +-+
|     | |   | | | | | |   | | | |   | | |
+ + + + +-+-+ + + +-+-+-+-+ + + + +-+-+ +
| | | |   |     | |           | |   |   |
+ +-+ + + + +-+ +-+ +-+-+-+ + + +-+-+ + +
|   | | |   |     | |       |         | |
+-+ + + + + +-+-+ +-+-+ +-+ + + +-+-+ + +
|   | | | |   |     |   |   | | |     | |
+-+-+-+-+-+-+-+-+-+-+-+-+-+-+-+-+-+-+-+ +

 DFS:
+ +-+-+-+-+-+-+-+-+-+-+-+-+-+-+-+-+-+-+-+
|1|4 5 8|   |0 9 8 1| | |     |     |   |
+ + + + + +-+-+-+ + + + +-+ +-+-+ +-+-+ +
|2 3|6|9 0|   |7 6|2  | | |       |     |
+-+-+ +-+ + + +-+ + +-+ + + +-+-+ + + + +
|0 9|7|2 1| | |4 5|3 4|         |   | | |
+-+ +-+-+ + +-+ +-+-+ +-+-+-+-+-+ + +-+ +
|2|8|5 4 3 0 1 2 3|0|5 6  |       | |   |
+ + + +-+ +-+-+-+-+ +-+ +-+-+ +-+-+ +-+-+
|1|7 6 1|8 9|     |9 8 7      |   | |   |
+ +-+-+ +-+-+-+ +-+-+-+ + +-+-+ +-+-+ +-+
|0|9 8|2 4 7| |5 4 3 2 1|   | | |   |   |
+ +-+ + + +-+ + +-+-+-+ +-+-+ + + +-+-+ +
|8 9|7|3|5 6|7 6    | | |     |         |
+ +-+ +-+-+-+ +-+-+-+ +-+ +-+ + +-+ +-+-+
|7 6 5|0|1|9 8|   | |   | |   | | | |   |
+-+ + + + + +-+-+ + +-+ + +-+ + + + + +-+
|4 3|4 3|1 0 2 5 6 7 8    | |   |     | |
+-+ +-+ + +-+ +-+-+-+ +-+-+ +-+ + +-+-+ +
|6 5|4 3 2|8|3 4|1 0 9 5 8  |   | |     |
+-+-+ + +-+ +-+-+ +-+-+ + +-+-+ + +-+ + +
|1|6 5|2|6 7|4 3 2|8|7 6|9|     | |   | |
+ + +-+-+ +-+ +-+ + +-+-+ +-+-+-+ +-+ +-+
|8 7|4|8 7 6 5|2 1|7|2 1 0    | |   | | |
+ +-+ + +-+ +-+ +-+ +-+ + +-+-+ +-+-+ + +
|9|1 0 9 5|9 0|3 4|5 6|3|4|       | |   |
+ + + +-+-+ +-+-+-+ +-+-+ + +-+-+ + + +-+
|0|2|3|5|1 0|9 8|4 3|0|1|5|   |       | |
+-+-+-+ +-+ +-+ +-+ + + + + +-+-+ +-+ + +
|3|9 8|4 3 2 6 7 4|2|8 7 6 7 8|     |   |
+ + + +-+-+-+-+ + + + +-+ +-+ +-+ +-+ + +
|2|0|3 2 1 0 9 8|5|0 9|5|2 6|9  |   | | |
+ +-+ +-+-+ + +-+ + + + + +-+ +-+-+ + +-+
|6 5 4|3|2 1|3|3|6|1|9|4 3|6|0| |   | | |
+ + + + +-+-+ + + +-+-+-+-+ + + + +-+-+ +
|7|4|5|0 9|5 4 6|7|6 5 4 3 2 1| |   |7 8|
+ +-+ + + + +-+ +-+ +-+-+-+ + + +-+-+ + +
|8 9|6|1|7 6|8 7 9|7|1 0 9 8|7 9 1 2 3|9|
+-+ + + + + +-+-+ +-+-+ +-+ + + +-+-+ + +
|1 0|7|2|8|4 5|1 0 2|3 2|5 4|8|0|6 5 4|0|
+-+-+-+-+-+-+-+-+-+-+-+-+-+-+-+-+-+-+-+ +

 Shortest Path:
+ +-+-+-+-+-+-+-+-+-+-+-+-+-+-+-+-+-+-+-+
|#|# # #|   |    # #| | |     |     |   |
+ + + + + +-+-+-+ + + + +-+ +-+-+ +-+-+ +
|# #| |# #|   |  #|#  | | |       |     |
+-+-+ +-+ + + +-+ + +-+ + + +-+-+ + + + +
|   | |  #| | |# #|# #|         |   | | |
+-+ +-+-+ + +-+ +-+-+ +-+-+-+-+-+ + +-+ +
| | |    # # # #  | |# #  |       | |   |
+ + + +-+ +-+-+-+-+ +-+ +-+-+ +-+-+ +-+-+
| |     |   |     |    #      |   | |   |
+ +-+-+ +-+-+-+ +-+-+-+ + +-+-+ +-+-+ +-+
| |   |     | |# # # # #|   | | |   |   |
+ +-+ + + +-+ + +-+-+-+ +-+-+ + + +-+-+ +
|   | | |   |# #    | | |     |         |
+ +-+ +-+-+-+ +-+-+-+ +-+ +-+ + +-+ +-+-+
|     | | |# #|   | |   | |   | | | |   |
+-+ + + + + +-+-+ + +-+ + +-+ + + + + +-+
|   |   |  # # # # # #    | |   |     | |
+-+ +-+ + +-+ +-+-+-+ +-+-+ +-+ + +-+-+ +
|   |     | |   |    # # #  |   | |     |
+-+-+ + +-+ +-+-+ +-+-+ + +-+-+ + +-+ + +
| |   | |   |     | |   |#|     | |   | |
+ + +-+-+ +-+ +-+ + +-+-+ +-+-+-+ +-+ +-+
|   | |       |   | |    #    | |   | | |
+ +-+ + +-+ +-+ +-+ +-+ + +-+-+ +-+-+ + +
| |       |   |   |   | |#|       | |   |
+ + + +-+-+ +-+-+-+ +-+-+ + +-+-+ + + +-+
| | | | |   |   |   | | |#|   |       | |
+-+-+-+ +-+ +-+ +-+ + + + + +-+-+ +-+ + +
| |   |           | |    # # #|     |   |
+ + + +-+-+-+-+ + + + +-+ +-+ +-+ +-+ + +
| | |           | |   | |   |#  |   | | |
+ +-+ +-+-+ + +-+ + + + + +-+ +-+-+ + +-+
|     | |   | | | | | |   | |#| |   | | |
+ + + + +-+-+ + + +-+-+-+-+ + + + +-+-+ +
| | | |   |     | |          #| |   |# #|
+ +-+ + + + +-+ +-+ +-+-+-+ + + +-+-+ + +
|   | | |   |     | |       |# # # # #|#|
+-+ + + + + +-+-+ +-+-+ +-+ + + +-+-+ + +
|   | | | |   |     |   |   | | |     |#|
+-+-+-+-+-+-+-+-+-+-+-+-+-+-+-+-+-+-+-+ +

 BFS:
+ +-+-+-+-+-+-+-+-+-+-+-+-+-+-+-+-+-+-+-+
|1|4 5 6|1 3|8 5 9 4|1|6|2 3 1|3 7 2|5 5|
+ + + + + +-+-+-+ + + + +-+ +-+-+ +-+-+ +
|2 3|7|8 0|3 6|0 5|7 9|9|1|8 4 8 2|9 5 9|
+-+-+ +-+ + + +-+ + +-+ + + +-+-+ + + + +
|3 8|9|5 2|9|1|7 2|0 2|2 4 4 3 0|7 3|0|6|
+-+ +-+-+ + +-+ +-+-+ +-+-+-+-+-+ + +-+ +
|3|4|2 8 4 6 0 4 8|8|3 4 5|2 9 1 4|0|3 6|
+ + + +-+ +-+-+-+-+ +-+ +-+-+ +-+-+ +-+-+
|4|0 5 9|7 1|9 5 8|4 9 6 7 0 5|4 7|6|0 4|
+ +-+-+ +-+-+-+ +-+-+-+ + +-+-+ +-+-+ +-+
|5|3 3|3 6 1|5|3 0 7 3 8|1 6|5|0|5 8|1 4|
+ +-+ + + +-+ + +-+-+-+ +-+-+ + + +-+-+ +
|6 6|5|7|2 6|1 6 0 4|7|2|8 9 8|7 1 6 9 1|
+ +-+ +-+-+-+ +-+-+-+ +-+ +-+ + +-+ +-+-+
|5 6 9|3|9|1 6|0 4|1|8 1|9|5 6|5|3|0|2 1|
+-+ + + + + +-+-+ + +-+ + +-+ + + + + +-+
|5 4|4 6|2 7 1 7 7 5 2 7 2|0|4 9|6 2 5| |
+-+ +-+ + +-+ +-+-+-+ +-+-+ +-+ + +-+-+ +
|4 4|8 9 0|1|8 8|2 4 8 3 0 9|9 6|4|8 4 7|
+-+-+ + +-+ +-+-+ +-+-+ + +-+-+ + +-+ + +
|7|0 5|7|5 8|3 3 2|5|1 1|0|7 2 8|2|5 0| |
+ + +-+-+ +-+ +-+ + +-+-+ +-+-+-+ +-+ +-+
|6 7|4|6 4 8 2|2 2|6|0 1 1 9 7|1|5 9|6|1|
+ +-+ + +-+ +-+ +-+ +-+ + +-+-+ +-+-+ + +
|8|6 3 9 2|3 3|1 7|9 7|9|0|0 3 8 2|5|3 7|
+ + + +-+-+ +-+-+-+ +-+-+ + +-+-+ + + +-+
|7|0|5|9|7 4|1 6|0 5|4|1|8|7 1|9 3 7 6|2|
+-+-+-+ +-+ +-+ +-+ + + + + +-+-+ +-+ + +
| |4 2|3 0 6 9 2 7|0|2 2 6 0 8|9 8 7|4 8|
+ + + +-+-+-+-+ + + + +-+ +-+ +-+ +-+ + +
| | |8 3 9 0 3 8|2|8 5|6|1 9|2 4|8 5|9|3|
+ +-+ +-+-+ + +-+ + + + + +-+ +-+-+ + +-+
|  6 3| |2 8|9|5|8|1|7|3 0|6|5|0|5 0|4|7|
+ + + + +-+-+ + + +-+-+-+-+ + + + +-+-+ +
| | |5|  2|1 7 0|6|9 4 5 8 4 9|0|6 9|1 6|
+ +-+ + + + +-+ +-+ +-+-+-+ + + +-+-+ + +
|   | | |1 7|9 6 8|4|8 3 4 7|3 4 1 1 6|8|
+-+ + + + + +-+-+ +-+-+ +-+ + + +-+-+ + +
|   | | |3|0 1|  0  |3 7|2 3|5|2|9 7 2|0|
+-+-+-+-+-+-+-+-+-+-+-+-+-+-+-+-+-+-+-+ +

 Shortest Path:
+ +-+-+-+-+-+-+-+-+-+-+-+-+-+-+-+-+-+-+-+
|#|# # #|   |    # #| | |     |     |   |
+ + + + + +-+-+-+ + + + +-+ +-+-+ +-+-+ +
|# #| |# #|   |  #|#  | | |       |     |
+-+-+ +-+ + + +-+ + +-+ + + +-+-+ + + + +
|   | |  #| | |# #|# #|         |   | | |
+-+ +-+-+ + +-+ +-+-+ +-+-+-+-+-+ + +-+ +
| | |    # # # #  | |# #  |       | |   |
+ + + +-+ +-+-+-+-+ +-+ +-+-+ +-+-+ +-+-+
| |     |   |     |    #      |   | |   |
+ +-+-+ +-+-+-+ +-+-+-+ + +-+-+ +-+-+ +-+
| |   |     | |# # # # #|   | | |   |   |
+ +-+ + + +-+ + +-+-+-+ +-+-+ + + +-+-+ +
|   | | |   |# #    | | |     |         |
+ +-+ +-+-+-+ +-+-+-+ +-+ +-+ + +-+ +-+-+
|     | | |# #|   | |   | |   | | | |   |
+-+ + + + + +-+-+ + +-+ + +-+ + + + + +-+
|   |   |  # # # # # #    | |   |     | |
+-+ +-+ + +-+ +-+-+-+ +-+-+ +-+ + +-+-+ +
|   |     | |   |    # # #  |   | |     |
+-+-+ + +-+ +-+-+ +-+-+ + +-+-+ + +-+ + +
| |   | |   |     | |   |#|     | |   | |
+ + +-+-+ +-+ +-+ + +-+-+ +-+-+-+ +-+ +-+
|   | |       |   | |    #    | |   | | |
+ +-+ + +-+ +-+ +-+ +-+ + +-+-+ +-+-+ + +
| |       |   |   |   | |#|       | |   |
+ + + +-+-+ +-+-+-+ +-+-+ + +-+-+ + + +-+
| | | | |   |   |   | | |#|   |       | |
+-+-+-+ +-+ +-+ +-+ + + + + +-+-+ +-+ + +
| |   |           | |    # # #|     |   |
+ + + +-+-+-+-+ + + + +-+ +-+ +-+ +-+ + +
| | |           | |   | |   |#  |   | | |
+ +-+ +-+-+ + +-+ + + + + +-+ +-+-+ + +-+
|     | |   | | | | | |   | |#| |   | | |
+ + + + +-+-+ + + +-+-+-+-+ + + + +-+-+ +
| | | |   |     | |          #| |   |# #|
+ +-+ + + + +-+ +-+ +-+-+-+ + + +-+-+ + +
|   | | |   |     | |       |# # # # #|#|
+-+ + + + + +-+-+ +-+-+ +-+ + + +-+-+ + +
|   | | | |   |     |   |   | | |     |#|
+-+-+-+-+-+-+-+-+-+-+-+-+-+-+-+-+-+-+-+ +
 MAZE COMPLETED!
